1111111111111111111111111111111111111111111
1000000000000000000000000000000000000000001
1010101101110100011101110011001000101000101
1010101000100100010101C10100101100101100101
101110110010010001110111010E101010101010101
1010101000100100010101100100101001101001101
1010101101110111011101010011001000101000101
1P00000000000000000000000000000000000000001
1111111111111111111111111111111111111111111