1111111111111111111111111111111111111111
1C000000000000000000K00000000000000000E1
1K01111011110000010000111101100101111001
1001000010010000010000100101100101000001
1001000010010000010000100101010101000001
1001111010010000010000100101010101011001
10000010100100000100001001010101010C1001
10000010100100000100001001010011010010K1
1001111011110111011110111101001101111001
1P0K000000000000000000000000000000000KC1
1111111111111111111111111111111111111111