1111111111111
1KK10000000C1
10000111110K1
1P0011E000001
1111111111111