1111111111111111111111111111111111
1E0000000000000CK000KC000000000001
10100101001K0000101001000000010101
1010010010101010001001000000010101
1P0000000C00C000000K000000000000C1
1111111111111111111111111111111111