11111111111111111111
100001000CKC00100001
101101C110C110101101
1000000KC0CK10000001
10101101101110110101
10100001000010100101
1C101101011010101101
1E1000000P00001C0001
11111111111111111111